TORUS 20 10
####################
  P >  e >    >    >
    >  e > e  >  e >
 *  >  e >    >    >
    >  e >    >    >
  P >  e > e  >  e >
    >  e >    >    >
    >  e > *  >  * >
 h  >  e >    >  e >
####################
