TORUS 20 10
####################
  P >    <    >    >
    >    < e  >  e >
 *  >    <    >    >
    >    <    >    >
  P >    > e  >  e >
    >    >    >    >
    >    < *  >  * >
 h  >    <    >  e >
####################
